########
#O PX  #
#     #
# O X  #
#    P #
########
