############
#       #O #
#   P   #  #
# X     #  #
#######    #
#  O ##    #
#    ##    #
#          #
#      XX  #
#O     #   #
############
