############
#       #O #
#   P   #  #
# X     #  #
#          #
#          #
#          #
#          #
#      XX ##
#O     #####
############
