#######
#   ###
#  X ##
#O   P#
#######
