##########
#  P     #
#        #
#  XO  ###
#        #
# OX     #
##########
